11111111111111111111111111
1010C000000000000000C00001
1100000000000000000CC00001
10000000000010000000000001
10C00000000010000000000001
10C0P000000010000000000001
10C00000000000000010000001
10000000000010000000000001
10000000000010000000000001
10000000000010000000C000C1
10000000000000000000000001
10000E00000000000000000001
10000000000000000000000001
11111111111111111111111111