111111111111111111111111111111111
111111111111000000111111111111111
111111111111111111111111111111111
11110E00C00P101111111111111111111
111110000001100011111111111111111
110000011111100000000000001111111
110000000000000001111111111111111
111111000001111111111111111111111
111111111111111111111111111111111
111111111111111111111111111111111