111111111111111111111111
1P0000000000000000000001
1000000C0000000000000001
100000000000000000000001
100E00000000000000000001
100000000000000000000001
100000000000000000000001
111111111111111111111111
