111111111111111111111111111111111
100000000000000000000001000000001
10000000000000000000001P000000001
1000E0000000000000000001000000001
10000000000C000000000000000000001
100000000000000000000000000000001
100000000000000000000000000000001
100000000000000000000000000000001
111111111111111111111111111111111