11111111111
10000000001
1E000001001
11110000011
100010P0101
11111111111
