11111111111
10000C00011
1E000001001
111100C0111
100010P0101
11111111111
