111111111111
100000000001
100000000001
110000000001
111100000011
1000100000P1
111111111111
