1111111111
10000C0101
10E0000111
10000P0101
1111111111
