111111111111111111111111111111111
100000000000000000000000000000001
10000000000000000P000000000000001
1000000000E0000000000000000000011
100000000000000000000000000000001
100000000000000001000000000000001
1000000C000000001C100000000000001
100000000000000001000000000000001
100000000000000000000000000000001
111111111111111111111111111111111
