111111111111111111111111
1110P00E0CCC000000000001
110000000000000000000001
111000000000000000000001
100000000000000000000001
111111111111111111111111
