111111111111111111111111
100000000ECCC00000000001
100000000P00000000000001
111111111111111111111111
