11111111111
10P00000001
10000C011E1
10000001101
11111111111
