11111111111
10P00E00101
10000C01101
1000C001101
11111111111
