11111111
1010C001
11EP0001
11111111