111111111111111111111111
1111000PEC00000000000C01
11000000000000000000C001
111000000000000000000001
100000000000000000000001
111111111111111111111111
