111111111111111111111111
100000000000000000000001
1000000000C0000000000001
100000000000P00000000001
1000000000E0000000000001
100000000000000000000001
100000000000000000000001
111111111111111111111111
