11111111111
100C0C00011
100E0000011
111100C0111
10P01000101
11111111111
