11111111111
10C00000011
100E00C0011
11111000111
10P0100C101
11111111111
