111111111111111111111111
111000P0E0CCC00000000001
110000000000000000000001
111000000000000000000001
110000000000000000000001
111111111111111111111111
