1111111111111111111
1000C00000000E01011
1000000000001000101
100C00100C0P0000111
1111111111111111111
