11111111111
10000001001
1000EC010P1
10000001001
11111111111
