11111111111111111
1P000000000000001
1000000000C000001
1000000E000000001
11111111111111111
